...........
...........
...........
......#...%
.....###...
......#....
@.....#....
#####...###